Abandon	1.to leave somebody, especially somebody you are responsible for, with no intention of returning	/əˈbændən/
Ability	3.ability to do something the fact that somebody/something is able to do something	/əˈbɪləti/
About	1.a little more or less than; a little before or after	/əˈbaʊt/
Above 	1.at or to a higher place	/əˈbʌv/
Abroad	1.in or to a foreign country	/əˈbrɔːd/
Absolute	1.total and complete	/ˈæbsəluːt/
Access	5.the opportunity or right to use something or to see somebody/something	/ˈækses/
Back	1. located behind or at the back of something	/bæk/
Backwards	1. located behind or at the back of somethingtowards a place or position that is behind	/ˈbækwədz/
Ban	3.an official rule that says that something is not allowed	/bæn/
Compatible	Tuong thich	/kəmˈpætəbl/
Constrain	Ep buoc	/kənˈstreɪn/
Conversion	Su chuyen bien	/kənˈvɜːrʒn/
Correspond	Tuong ung	/ˌkɒrəˈspɒnd/
Daily 	1. happening, done or produced every day	/ˈdeɪli/
Damage	1. [uncountable] physical harm caused to something which makes it less attractive, useful or valuable	/ˈdæmɪdʒ/
Dangerous	3.likely to injure or harm somebody, or to damage or destroy something	/ˈdeɪndʒərəs/
Earthquake	1.​a sudden, violent shaking of the earth’s surface	/ˈɜːθkweɪk/
Economic	1.[only before noun] connected with the trade, industry and development of wealth of a country, an area or a society	/ˌekəˈnɒmɪk/
Education	1.[uncountable, countable] a process of teaching, training and learning, especially in schools, colleges or universities, to improve knowledge and develop skills	/ˌedʒuˈkeɪʃn/
Face 	1.the front part of the head, where the eyes, nose and mouth are	/feɪs/
Fact	7.[countable] a thing that is known to be true, especially when it can be proved	/fækt/
Flower	Bong hoa	/ˈflaʊə/
Gain	1.[countable, uncountable] an increase in the amount of something, especially in wealth or weight	/ɡeɪn/
Goodbye	Tam biet	/ˌɡʊdˈbaɪ/
Hello	Xin chao	/həˈləʊ/
Kick 	1.[transitive, intransitive] to hit somebody/something with your foot	/kɪk/
Target	Muc tieu	/ˈtɑːɡɪt/
Teacher	Thay giao	/ˈtiːtʃər/
Television	Ti vi	/ˈtelɪvɪʒn/
Tell	Noi	/tel/
Term	Thoi han	/tɜːrm/
Type	Loai,tip	/taɪp/
