Bus	Xe buyt
Coat	Ao choang
Compatible	Tuong thich
Constrain	Ep buoc
Conversion	Su chuyen bien
Correspond	Tuong ung
Flower	Bong hoa
Hello	Xin chao
Target	Muc tieu
Teacher	Thay giao
Tell	Noi
Term	Thoi han
Tired	Met moi
Total	Tong cong
Touch	So mo
Trade	Trao doigoodbye
Type	Loai,tip
Wear	Mac
Win	Chien thang
Wire	Day kim loai
